000000000000000000000000000000000000000000000000
000000000000000000000000000000000000000000000000
000000000000000000000000000000000000000000000000
000000000000000000000000000000000000000000000000
000000000000000000000000000000000000000000000000
000000000000000000000011111111000000000000000000
000000000000000000000111111111000000000000000000
P0000000E000000000001111111111000000000E00000040
111111111111111111111111111111111111111111111111
111111111111111111111111111111111111111111111111
